Thanks to TeamSpen210 for providing this data

additive	FLAG
allowalphatocoverage	FLAG
alphatest	FLAG
basealphaenvmapmask	FLAG
debug	FLAG
decal	FLAG
envmapcameraspace	FLAG
envmapmode	FLAG
envmapsphere	FLAG
flat	FLAG
halflambert	FLAG
ignorez	FLAG
model	FLAG
multipass	FLAG
no_draw	FLAG
no_fullbright	FLAG
noalphamod	FLAG
nocull	FLAG
nodecal	FLAG
nofog	FLAG
normalmapalphaenvmapmask	FLAG
opaquetexture	FLAG
selfillum	FLAG
softwareskin	FLAG
translucent	FLAG
use_in_fillrate_mode	FLAG
vertexalpha	FLAG
wireframe	FLAG
znearer	FLAG
translucent_material	MATERIAL
fallback	STR
pixshader	STR
vertexshader	STR
albedo	TEXTURE
alphamasktexture	TEXTURE
ambientoccltexture	TEXTURE
basetexture	TEXTURE
basetexture2	TEXTURE
basetexture3	TEXTURE
basetexture4	TEXTURE
blendmodulatetexture	TEXTURE
bloomtexture	TEXTURE
blurredtexture	TEXTURE
blurtexture	TEXTURE
bumpcompress	TEXTURE
bumpmap	TEXTURE
bumpmap2	TEXTURE
bumpmask	TEXTURE
bumpstretch	TEXTURE
cbtexture	TEXTURE
cloudalphatexture	TEXTURE
colorwarptexture	TEXTURE
compress	TEXTURE
cookietexture	TEXTURE
corecolortexture	TEXTURE
corneatexture	TEXTURE
crtexture	TEXTURE
delta	TEXTURE
depthtexture	TEXTURE
detail	TEXTURE
displacementmap	TEXTURE
dudvmap	TEXTURE
dust_texture	TEXTURE
effectmaskstexture	TEXTURE
emissiveblendbasetexture	TEXTURE
emissiveblendflowtexture	TEXTURE
emissiveblendtexture	TEXTURE
envmap	TEXTURE
envmapmask	TEXTURE
exposure_texture	TEXTURE
fb_texture	TEXTURE
fbtexture	TEXTURE
fleshbordertexture1d	TEXTURE
fleshcubetexture	TEXTURE
fleshinteriornoisetexture	TEXTURE
fleshinteriortexture	TEXTURE
fleshnormaltexture	TEXTURE
fleshsubsurfacetexture	TEXTURE
flow_noise_texture	TEXTURE
flowmap	TEXTURE
fow	TEXTURE
frametexture	TEXTURE
fresnelcolorwarptexture	TEXTURE
glassenvmap	TEXTURE
glint	TEXTURE
gradienttexture	TEXTURE
grain	TEXTURE
grain_texture	TEXTURE
hdrbasetexture	TEXTURE
hdrcompressedtexture	TEXTURE
hdrcompressedtexture0	TEXTURE
hdrcompressedtexture1	TEXTURE
hdrcompressedtexture2	TEXTURE
input	TEXTURE
input_texture	TEXTURE
internal_vignettetexture	TEXTURE
iridescentwarp	TEXTURE
iris	TEXTURE
lightwarptexture	TEXTURE
noisetexture	TEXTURE
normalmap	TEXTURE
normalmap2	TEXTURE
opacitytexture	TEXTURE
originaltexture	TEXTURE
paintsplatenvmap	TEXTURE
paintsplatnormalmap	TEXTURE
phongexponenttexture	TEXTURE
phongwarptexture	TEXTURE
portalcolortexture	TEXTURE
portalmasktexture	TEXTURE
ramptexture	TEXTURE
reflecttexture	TEXTURE
refracttexture	TEXTURE
refracttinttexture	TEXTURE
screeneffecttexture	TEXTURE
selfillummap	TEXTURE
selfillummask	TEXTURE
selfillumtexture	TEXTURE
shadowdepthtexture	TEXTURE
sidespeed	TEXTURE
smallfb	TEXTURE
sourcemrtrendertarget	TEXTURE
spectexture	TEXTURE
spectexture2	TEXTURE
spectexture3	TEXTURE
spectexture4	TEXTURE
staticblendtexture	TEXTURE
stretch	TEXTURE
texture0	TEXTURE
texture1	TEXTURE
texture2	TEXTURE
texture3	TEXTURE
texture4	TEXTURE
transmatmaskstexture	TEXTURE
velocity_texture	TEXTURE
ytexture	TEXTURE
addoverblend	INT
alpha_blend	INT
alpha_blend_color_overlay	INT
alphablend	INT
alphadepth	INT
alphamasktextureframe	INT
ambientboostmaskmode	INT
ambientonly	INT
basemapalphaphongmask	INT
basemapluminancephongmask	INT
bloomtintenable	INT
bloomtype	INT
bluramount	INT
bumpframe	INT
bumpframe2	INT
clearalpha	INT
clearcolor	INT
cleardepth	INT
cookieframenum	INT
copyalpha	INT
corecolortextureframe	INT
cull	INT
depthblend	INT
depthtest	INT
desaturateenable	INT
detailblendmode	INT
detailframe	INT
disable_color_writes	INT
dualsequence	INT
dudvframe	INT
enableshadows	INT
envmapframe	INT
envmapmaskframe	INT
extractgreenalpha	INT
fade	INT
flowmapframe	INT
frame	INT
frame2	INT
frame3	INT
gammacolorread	INT
invertphongmask	INT
irisframe	INT
kernel	INT
linearread_basetexture	INT
linearread_texture1	INT
linearread_texture2	INT
linearread_texture3	INT
linearwrite	INT
maskedblending	INT
maxlumframeblend1	INT
maxlumframeblend2	INT
mirroraboutviewportedges	INT
mode	INT
mrtindex	INT
multiplycolor	INT
nocolorwrite	INT
nodiffusebumplighting	INT
noviewportfixup	INT
nowritez	INT
orientation	INT
parallaxmap	INT
passcount	INT
pointsample_basetexture	INT
pointsample_texture1	INT
pointsample_texture2	INT
pointsample_texture3	INT
quality	INT
receiveflashlight	INT
refracttinttextureframe	INT
renderfixz	INT
selfillumtextureframe	INT
sequence_blend_mode	INT
shadowdepth	INT
singlepassflashlight	INT
splinetype	INT
spriteorientation	INT
spriterendermode	INT
ssbump	INT
stage	INT
staticblendtextureframe	INT
tcsize0	INT
tcsize1	INT
tcsize2	INT
tcsize3	INT
tcsize4	INT
tcsize5	INT
tcsize6	INT
tcsize7	INT
treesway	INT
tv_gamma	INT
uberlight	INT
usealternateviewmatrix	INT
vertexalphatest	INT
vertexcolor	INT
vertextransform	INT
writealpha	INT
writedepth	INT
x360appchooser	INT
addbasetexture2	FLOAT
addself	FLOAT
alpha	FLOAT
alpha2	FLOAT
alphasharpenfactor	FLOAT
alphatested	FLOAT
alphatestreference	FLOAT
alphatrailfade	FLOAT
ambientboost	FLOAT
ambientocclusion	FLOAT
autoexpose_max	FLOAT
autoexpose_min	FLOAT
backscatter	FLOAT
bloomamount	FLOAT
bloomexp	FLOAT
bloomexponent	FLOAT
bloomsaturation	FLOAT
blurredvignettescale	FLOAT
bumpstrength	FLOAT
c0_w	FLOAT
c0_x	FLOAT
c0_y	FLOAT
c0_z	FLOAT
c1_w	FLOAT
c1_x	FLOAT
c1_y	FLOAT
c1_z	FLOAT
c2_w	FLOAT
c2_x	FLOAT
c2_y	FLOAT
c2_z	FLOAT
c3_w	FLOAT
c3_x	FLOAT
c3_y	FLOAT
c3_z	FLOAT
c4_w	FLOAT
c4_x	FLOAT
c4_y	FLOAT
c4_z	FLOAT
cheapwaterenddistance	FLOAT
cheapwaterstartdistance	FLOAT
cloakfactor	FLOAT
color_flow_lerpexp	FLOAT
color_flow_timeintervalinseconds	FLOAT
color_flow_timescale	FLOAT
color_flow_uvscale	FLOAT
color_flow_uvscrolldistance	FLOAT
contrast	FLOAT
corneabumpstrength	FLOAT
deltascale	FLOAT
depthblendscale	FLOAT
depthblurfocaldistance	FLOAT
depthblurstrength	FLOAT
desaturatewithbasealpha	FLOAT
desaturation	FLOAT
detailblendfactor	FLOAT
detailscale	FLOAT
diffuseexponent	FLOAT
diffusesoftnormal	FLOAT
dilation	FLOAT
edge_softness	FLOAT
edgesoftnessend	FLOAT
edgesoftnessstart	FLOAT
emissiveblendstrength	FLOAT
endfadesize	FLOAT
envmapcontrast	FLOAT
envmapfresnel	FLOAT
envmaplightscale	FLOAT
envmapmaskscale	FLOAT
envmapsaturation	FLOAT
eyeballradius	FLOAT
fadetoblackscale	FLOAT
falloffamount	FLOAT
falloffdistance	FLOAT
falloffoffset	FLOAT
farblurdepth	FLOAT
farblurradius	FLOAT
farfadeinterval	FLOAT
farfocusdepth	FLOAT
farplane	FLOAT
flashlighttime	FLOAT
flashlighttint	FLOAT
fleshbordernoisescale	FLOAT
fleshbordersoftness	FLOAT
fleshborderwidth	FLOAT
fleshglobalopacity	FLOAT
fleshglossbrightness	FLOAT
fleshscrollspeed	FLOAT
flow_bumpstrength	FLOAT
flow_noise_scale	FLOAT
flow_normaluvscale	FLOAT
flow_timeintervalinseconds	FLOAT
flow_timescale	FLOAT
flow_uvscrolldistance	FLOAT
flow_worlduvscale	FLOAT
flowmaptexcoordoffset	FLOAT
fogend	FLOAT
fogexponent	FLOAT
fogscale	FLOAT
fogstart	FLOAT
forcefresnel	FLOAT
forwardscatter	FLOAT
fresnelbumpstrength	FLOAT
fresnelpower	FLOAT
fresnelreflection	FLOAT
glossiness	FLOAT
glowalpha	FLOAT
glowend	FLOAT
glowstart	FLOAT
glowx	FLOAT
glowy	FLOAT
groundmax	FLOAT
groundmin	FLOAT
hdrcolorscale	FLOAT
height_scale	FLOAT
hueshiftfresnelexponent	FLOAT
hueshiftintensity	FLOAT
illumfactor	FLOAT
interiorambientscale	FLOAT
interiorbackgroundboost	FLOAT
interiorbacklightscale	FLOAT
interiorfogstrength	FLOAT
interiorrefractblur	FLOAT
interiorrefractstrength	FLOAT
iridescenceboost	FLOAT
iridescenceexponent	FLOAT
lightmaptint	FLOAT
localcontrastedgescale	FLOAT
localcontrastmidtonemask	FLOAT
localcontrastscale	FLOAT
localcontrastvignetteend	FLOAT
magnifyscale	FLOAT
maxdistance	FLOAT
maxfalloffamount	FLOAT
maxlight	FLOAT
maxreflectivity	FLOAT
maxsize	FLOAT
minlight	FLOAT
minreflectivity	FLOAT
minsize	FLOAT
nearblurdepth	FLOAT
nearblurradius	FLOAT
nearfocusdepth	FLOAT
nearplane	FLOAT
noisestrength	FLOAT
normal2softness	FLOAT
num_lookups	FLOAT
numplanes	FLOAT
outlinealpha	FLOAT
outlineend0	FLOAT
outlineend1	FLOAT
outlinestart0	FLOAT
outlinestart1	FLOAT
overbrightfactor	FLOAT
parallaxstrength	FLOAT
phong2softness	FLOAT
phongboost	FLOAT
phongexponent	FLOAT
phongexponent2	FLOAT
phongscale	FLOAT
phongscale2	FLOAT
portalcolorscale	FLOAT
portalopenamount	FLOAT
portalstatic	FLOAT
pulserate	FLOAT
radiustrailfade	FLOAT
reflectamount	FLOAT
reflectance	FLOAT
reflectblendfactor	FLOAT
refractamount	FLOAT
rimlightboost	FLOAT
rimlightexponent	FLOAT
rimlightscale	FLOAT
rotation	FLOAT
rotation2	FLOAT
rotation3	FLOAT
rotation4	FLOAT
saturation	FLOAT
scale	FLOAT
scale2	FLOAT
scale3	FLOAT
scale4	FLOAT
screenblurstrength	FLOAT
seamless_scale	FLOAT
selfillum_envmapmask_alpha	FLOAT
selfillummaskscale	FLOAT
shadowatten	FLOAT
shadowfiltersize	FLOAT
shadowjitterseed	FLOAT
sharpness	FLOAT
silhouettethickness	FLOAT
ssbentnormalintensity	FLOAT
ssdepth	FLOAT
sstintbyalbedo	FLOAT
startfadesize	FLOAT
staticamount	FLOAT
time	FLOAT
toolcolorcorrection	FLOAT
tooltime	FLOAT
treeswayfalloffexp	FLOAT
treeswayheight	FLOAT
treeswayradius	FLOAT
treeswayscrumblefalloffexp	FLOAT
treeswayscrumblefrequency	FLOAT
treeswayscrumblespeed	FLOAT
treeswayscrumblestrength	FLOAT
treeswayspeed	FLOAT
treeswayspeedhighwindmultiplier	FLOAT
treeswayspeedlerpend	FLOAT
treeswayspeedlerpstart	FLOAT
treeswaystartheight	FLOAT
treeswaystartradius	FLOAT
treeswaystrength	FLOAT
uberroundness	FLOAT
unlitfactor	FLOAT
uvscale	FLOAT
vertexfogamount	FLOAT
vignette_min_bright	FLOAT
vignette_power	FLOAT
volumetricintensity	FLOAT
vomitrefractscale	FLOAT
warpparam	FLOAT
waterdepth	FLOAT
wave	FLOAT
weight0	FLOAT
weight1	FLOAT
weight2	FLOAT
weight3	FLOAT
weight_default	FLOAT
woodcut	FLOAT
zoomanimateseq2	FLOAT
aaenable	BOOL
abovewater	BOOL
allowdiffusemodulation	BOOL
allowlocalcontrast	BOOL
allownoise	BOOL
allowvignette	BOOL
basetexture2noenvmap	BOOL
basetexturenoenvmap	BOOL
blendframes	BOOL
blendtintbybasealpha	BOOL
blobbyshadows	BOOL
bloomenable	BOOL
blurredvignetteenable	BOOL
blurrefract	BOOL
bumpbasetexture2withbumpmap	BOOL
cloakpassenabled	BOOL
deferredshadows	BOOL
depthblurenable	BOOL
detail_alpha_mask_base_texture	BOOL
displacementwrinkle	BOOL
distancealpha	BOOL
distancealphafromdetail	BOOL
emissiveblendenabled	BOOL
enableclearcolor	BOOL
enablesrgb	BOOL
envmapoptional	BOOL
fadeoutonsilhouette	BOOL
flashlightnolambert	BOOL
fleshdebugforcefleshon	BOOL
fleshinteriorenabled	BOOL
flow_debug	BOOL
forcebump	BOOL
forcecheap	BOOL
forceexpensive	BOOL
forcerefract	BOOL
glow	BOOL
ignorevertexcolors	BOOL
interior	BOOL
intro	BOOL
inversedepthblend	BOOL
lightmapwaterfog	BOOL
localcontrastenable	BOOL
localcontrastvignettestart	BOOL
magnifyenable	BOOL
masked	BOOL
mod2x	BOOL
nofresnel	BOOL
noiseenable	BOOL
nolowendlightmap	BOOL
noscale	BOOL
nosrgb	BOOL
opaque	BOOL
outline	BOOL
perparticleoutline	BOOL
phong	BOOL
phongalbedotint	BOOL
phongdisablehalflambert	BOOL
raytracesphere	BOOL
reflectentities	BOOL
rimlight	BOOL
rimmask	BOOL
scaleedgesoftnessbasedonscreenres	BOOL
scaleoutlinesoftnessbasedonscreenres	BOOL
seamless_base	BOOL
seamless_detail	BOOL
selfillumfresnel	BOOL
separatedetailuvs	BOOL
shadersrgbread360	BOOL
showalpha	BOOL
softedges	BOOL
spheretexkillcombo	BOOL
toolmode	BOOL
translucentgoo	BOOL
unlit	BOOL
use_fb_texture	BOOL
useinstancing	BOOL
usingpixelshader	BOOL
vertexcolorlerp	BOOL
vertexcolormodulate	BOOL
vignetteenable	BOOL
vomitenable	BOOL
writez	BOOL
zfailenable	BOOL
cloakcolortint	COLOR
colortint	COLOR
detailtint	COLOR
emissiveblendtint	COLOR
envmaptint	COLOR
fleshbordertint	COLOR
fleshsubsurfacetint	COLOR
fogcolor	COLOR
glassenvmaptint	COLOR
glowcolor	COLOR
outlinecolor	COLOR
reflecttint	COLOR
refracttint	COLOR
scroll1	COLOR
scroll2	COLOR
selfillumtint	COLOR
silhouettecolor	COLOR
tint	COLOR
basetextureoffset	VEC2
basetexturescale	VEC2
bumpoffset	VEC2
cloudscale	VEC2
cropfactor	VEC2
emissiveblendscrollvector	VEC2
flowmapscrollrate	VEC2
magnifycenter	VEC2
maskscale	VEC2
refractionamount	VEC2
ambientocclcolor	VEC3
basealphaenvmapmaskminmaxexp	VEC3
bbmax	VEC3
bbmin	VEC3
color	VEC3
dimensions	VEC3
entityorigin	VEC3
envmapfresnelminmaxexp	VEC3
eyeorigin	VEC3
eyeup	VEC3
forward	VEC3
interiorcolor	VEC3
leafcenter	VEC3
lerpcolor1	VEC3
lerpcolor2	VEC3
light_color	VEC3
light_position	VEC3
phongcolortint	VEC3
phongfresnel	VEC3
phongfresnel2	VEC3
phongfresnelranges	VEC3
phongtint	VEC3
spriteorigin	VEC3
sscolortint	VEC3
translucentfresnelminmaxexp	VEC3
uvprojoffset	VEC3
vomitcolor1	VEC3
vomitcolor2	VEC3
aainternal1	VEC4
aainternal2	VEC4
aainternal3	VEC4
attenfactors	VEC4
channel_select	VEC4
fadecolor	VEC4
flashlightcolor	VEC4
flesheffectcenterradius1	VEC4
flesheffectcenterradius2	VEC4
flesheffectcenterradius3	VEC4
flesheffectcenterradius4	VEC4
glintu	VEC4
glintv	VEC4
hslnoisescale	VEC4
irisu	VEC4
irisv	VEC4
motionblurinternal	VEC4
motionblurviewportinternal	VEC4
noisescale	VEC4
originfarz	VEC4
quatorientation	VEC4
scalebias	VEC4
selfillumfresnelminmaxexp	VEC4
uberheightwidth	VEC4
ubernearfar	VEC4
weights	VEC4
alternateviewmatrix	MATRIX
basetexturetransform	MATRIX
basetexturetransform2	MATRIX
blendmasktransform	MATRIX
bumptransform	MATRIX
bumptransform2	MATRIX
detailtexturetransform	MATRIX
detailtransform	MATRIX
envmapmasktransform	MATRIX
orientationmatrix	MATRIX
texture2transform	MATRIX
texturetransform	MATRIX
worldtotexture	MATRIX
lights	FOUR_CC
bottommaterial	MATERIAL
crackmaterial	MATERIAL
